+-+-+-+-+-+-+-+-+-+-+
|S|  O| | |E  | |O  |
+ +-+ + + +-+ + +-+ +
|O  |  O| |  O  |   |
+ + + +-+ +-+ +-+-+ +
| |  O|    O      | |
+ +-+-+ +-+-+ +-+ + +
|      O|     |  O  |
+-+ + +-+-+ +-+ +-+-+
|    O     O  | |  O|
+-+-+ +-+-+-+-+ +-+ +
|  O O        |O   O|
+-+-+-+-+-+-+-+-+-+-+