+-+-+-+-+-+-+-+
| |  O|E| |   |
+ +-+ + + +-+ +
|O  |  O|     |
+ + + +-+ +-+ +
|S|  O|    O| |
+ +-+-+ +-+-+ +
|      O|     |
+-+ + +-+-+ +-+
|    O        |
+-+-+-+-+-+-+-+